##########
#.......##
#........#
#........#
#...#....#
#..###...#
#...###..#
#....#...#
#.......##
##########
