##########
#........#
#........#
#........#
#...#....#
#..###...#
#...###..#
#....#...#
#........#
##########
