###########
#.......#.#
#.........#
#.........#
#...#.....#
#..###....#
#...###...#
#....#....#
#.......#.#
###########
